 _________
| |  ___  |
| |_  |___|
|_  |___  |
| |_____  |
|_   ___| |
|  _|   | |
|_____|___|
